6
5,3
7,4
5,5
7,5
2,8
5,8
11,9
19,13
0000000000000000000
0000111110000000000
0000122210000000000
0000122210000000000
0011122211000000000
0012222221000000000
1112121121111111111
1222121122222222331
1222222222222222331
1111121112222222331
0000111111111111111
0000111111100000000
0000000000000000000