2
2,3
2,5
1,2
5,8
00000
11111
12221
12221
11121
13221
12231
11111