2
2,2
2,4
1,1
5,7
11111
12221
12221
11121
13221
12231
11111